嘉心糖	夹心糖
奶淇淋	n70	乃70	奶70	奶琪琳	奶淇琳
顶碗人	顶晚人
皇珈骑士 皇家骑士
乃老师	奶老师
嘉门	嘉们
铸币	猪鼻
寄吧	几把	鸡吧	鸡巴
一眼真	一眼假
嗦嗨嗨	索嗨嗨
银屯	银豚	银臀	银吞
本音民	扭曲民
惹啊	惹阿
没转对 转错了
蚌埠住了	绷不住了	bon不jour了
上大分了	上分了	上分
紫砂	自杀
拉胯	拉垮	拉跨
易拉罐	ylg	引流狗
我一直是	我一直都是
罕见	太罕见	太罕见了	勾罕见	狗罕见
果咩纳塞	果咩
寄	寄!	g了	寄！
好	好
我爹  我蝶
啊笑死	啊，笑死	阿，笑死	阿,笑死	xs	XS	啊 笑死	阿 笑死
A-soul	asoul	Asoul	a手	A手
给你一拳	给你一圈
你再想想	你在想想
她是我爹	他是我爹
燃起来了	然起来了
懂的都懂	懂得都懂
怎么会事呢	怎么回事呢	怎么会是呢	怎么回是呢
最高指令	最高指示
引流	万象天引
来点作用	给点作用
已经不是小v了	已经不是小V了	不是小v了	不是小V了	小v了	小V了
快	快快	块	块快	块块	快快快
呜呜呜 呜呜  呜
欧西给	欧系给	哦系给	哦西给	欧洗给
又是她	又是他
不许说她	不许说他	不许说我爹	不许说我蝶	不允许说他	不允许说她	不允许说我爹	不允许说我蝶
晚安	晚安捏
好好好 好好
小向晚	小 向 晚
晚晚	我的晚	晚的	的晚
卧槽	我操	我草	握草	卧草	我曹	我糙	woc	我糙	我超
我要吃这个	要吃这个
这tm是个啥啊	是个啥啊	是个啥啊	这tm是个啥
一个魂儿	一个魂
小乃琳	小 乃 琳
工具人	小1	小一
陈睿	cr	陈瑞	晋元帝	司马睿
不是很友善	不是很友好
同一批人	一批人
皇珈小丑	皇家小丑
乐	乐乐	乐乐乐
捏麻麻	涅麻麻
逆天	逆大天
土	土土	土土土	土味	垚	金木水火
嘴硬	还在嘴硬
奶贝	乃贝
mua	亲亲	要亲亲
furry	福瑞	富瑞	福睿	富睿
爱乐信乐等乐	爱信等	爱乐	信乐	等乐
山泥若	若子
恶心心	恶心
珈乐	王力口	王力口乐
A友	au	AU	a友
甜	甜甜	甜甜甜	舌甘
乌兹	污渍	uzi	UZI
销户	小虎	一虎
2200	zzoo
二珈	二甲	二假
羊	羊羊
狂小琳	狂小0	狂小淋
有代	有小代	小代	小代不算代	通天代	代
好听	好汀
阿巴巴阿巴	阿巴
差不多得了	扎不多
鲨人	shark
这下二了	早该二二了	就二
二次元	二刺螈	二刺猿
亚撒西	压撒洗	亚撒西	亚撒洗
000	0000	00
一眼rp	一眼RP
粉色小恶魔	粉色恶魔	小恶魔
三板斧	3板斧
潮	潮潮潮	潮潮
【B限】	【b限】	B限	b限
抖友	抖u
小然好久没直播	小然，好久没直播
【3D】	【3d】	[3d]	[3D]
又是他	又是她
au	AU	A友	a友
王思聪	wsc	王校长	撕葱	思聪
大鹅	小鹅鹅	大白鹅
挨打	挨铁棍	挨棍
粉比	粉笔
结界	jiejie	节节	杰杰
郭楠	果篮	国男	国楠	xdz	Xdz	XDZ
华为不卡	荣耀不卡	鸿蒙不卡
是真的	szd
俺捡嘞	俺捡
乳法	辱法
寻思	心思
啊嗯	阿嗯
达咩	大咩	dame	打咩
yhm	樱花妹
零元购	0元购
芜湖	芜芜	芜芜芜	芜
细说	细嗦
塔塔开	ttk	TTK	Ttk
嘉西德得	嘉西
我成替身了	成替身
才八点	才8点	c8d	cbd
才七点	才7点
fb矮	FB矮
杀疯了	鲨疯了
zzz	zz	ZZZ	ZZ
拙劣的模仿	拙劣模仿	拙模
run了	润了
私我一份	私我
上当	上大当
一百分	一搏分	一伯分	一博分
太潮了	太潮
YYDS	歪歪滴艾斯	永远滴神	永远的神
诶嘿	欸嘿	哎嘿
shark you	shark u	sharkyou
华子姐	杜华	杜妈
remake	重开
拆迁	拆家
病名为爹	病名为（）
塔の西	塔诺西
那个	内个
怎么推流辣	怎么推流
嘉然视角	然然视角	小然视角
hi	嗨
让我看看	让我康康
雀食蟀	确实帅
等老公	等女朋友	等女友	等老婆	陪老公	陪老婆	陪女朋友
人体，很神奇吧	人体，很奇妙吧	人体很神奇吧	人体很奇妙吧
医院有wifi	医院wifi
铁废物	铁five
帅	帅帅帅	帅帅
火影忍者	火影
世界第一初恋	世初
超电磁炮	超炮
晓之车	晓の车
高达seed	seed
butter fly	butterfly
妖精的尾巴	妖尾
四月是你的谎言	四谎
ab	angel beats	angelbeats
Clannad	cl
asoul大家族	as大家族	a手大家族
嘶哈	斯哈
乃琳错了	乃琳也错了	乃0也错了
快马加编	快马加鞭
病例	病历
~	波浪号 ～
KFC	肯德基
飞飞飞	飞飞	飞
卡特	不详之刃
麦拉了	麦坏了	麦掉了
我们才是虚拟的	我才是虚拟的	虚拟观众
拳皇	拳王
猪鼻草	铸币草
植物大战僵尸	pvz
倭瓜	窝瓜
★	☆
极限一换一	一换一
乃琳站起来跳舞	乃琳起来跳舞
严萝王	严罗王
老一辈一个魂	老一个魂	一个老魂
一刻都不想离开	不想离开
111	11
JOJO立 	jojo立
JOJO	jojo
西内	洗内
创死	创四
文成公主	然成公主	嘉成公主
A-SOUL	ASOUL	asoul	a-soul
小猪嘉然	小猪然然	小猪然比
全是感情	没有技巧
zqsg	真情实感
嘟嘟嘟	嘟嘟
A WITH U	with	U
珈步	乐步
jk拉舞	jk辣舞
一眼0	一眼乃琳	一眼琳
带糕乐	戴高乐
付费内容	付费节目
都喜欢	都爱
我我我	是我捏	是我吗
夏目友人帐	夏目
空之轨迹	空轨
好运镜	运镜好
一眼然	一眼小
QAQ	qaq
是真的	锁死了
ntr	牛头人
55	55下	56	五十五
一眼晚	一眼爹
懂了	看懂	看得懂
看不得这些	听不得这
三十年	30年
拉勾	拉钩
nya	nyanya	nyanyanya
no	nono	nonono
少儿频道	儿童频道
模仿向晚	向晚模仿大赛	模仿晚晚	模仿爹
pop star	popstar
打电话	电话突击
中	中嘞
师从	师承
乐儿啊	乐儿
乐啊乐	乐阿乐
经典再现	经典重现
你怎么还改词啊	怎么还改词	怎么改词
收到收到收到	收到收到	收到
你干的好啊	你干的好
届到了	届到
确实	雀食	雀氏
高雅	雅
对对对	对对	对
发病类	发病区
ow	守望先锋
大A特A	大a特a	apex
拉我进群	小团体拉我
很难不支持	河南拔智齿
软软软	软软	软
立大功	立功
16连败	十六连败
5u	5U	5友
乃宝	奶宝
奥日	ori
琳中毒	0中毒
演唱会	歌会
爱晚信晚等晚	爱信等
要要要	要要	要
衡水中学	衡水	衡中
合理	河里
上wc	厕所	wc	上厕所	上个厕所	
亚索	疾风剑豪	压缩	哈撒给
版本	新版本	版本落后	版本更新
幻	幻幻幻	幻幻
《》	《	》
魔法少女贝啦啦	魔法少女贝拉拉
橙子味大宝贝	橙子味哒宝bei
你失散已久的父亲	失散已久的父亲	失散多年的父亲	失散多年	失散已久
征服九亿少女	九亿少女	91少女	9亿少女	9E少女
贝拉拉	贝啦啦
secret player	secretplayer
au不错哦	au，不错哦
周董	杰伦	jay	周杰伦
777	77
勇敢牛牛	不怕困难
别欺负我爹	欺负我爹	欺负晚
烤阿草	烤啊草
小阿晚	小啊晚
屁用没有	p用没有
忠！诚！	忠！诚	忠!诚	忠诚
90秒	90s	九十秒
别紧张	不要紧张
琳浴歌姬	淋浴歌姬
Alien	alien	外星人
Rap	RAP	rap
好多v啊	好多v	好多V
我成年啦	我成年
↖↙↗↘	↖	↙	↗	↘
777	77
宅舞20连	宅舞二十连	20连	二十连
i can	I can
19分钟	十九分钟	19min
i do	I do	I DO
巜	巜巜	巜巜巜
动手	冻手
卧槽，别	我超别	我超，别	卧槽，别	卧槽 别	我超 别
tom	TOM	Tom
割了	噶了	切了
0	00	000
我不到啊	我不到
地道	地儿道儿
百京	百儿京儿
≈≈D	≈	≈D	=D	ᗡ≈	C≈
QAQ	v
跺jiojio	剁jiojio
？？？	???	?	??	？？	？
yes	Yes	YES
嘟嘟嘟	嘟嘟
java	Java	JAVA	珈ava
be	BE
ez	EZ
齐	齐齐	齐齐齐
晚	日免
卡卡卡	卡卡	卡	卡了
ed	ED
\(≧▽≦\)	⎛⎝≥⏝⏝≤⎛⎝	≥	≤
蒸汽波	蒸 汽 波